###################################
#..T...M..........................#
#.####..###...#######...###..####.#
#.#......................M....!.#.#
#.#.####..#######.#######..####.#.#
#...#.....#.............#....p#...#
#...#G....#......A......#.....#...#
#.#.####..###############..####.#.#
#.#..............M..............#.#
#.####..###...#######...###..####.#
#.................................#
#################^#################