#######
#.....#
#..A..#
#.....#
###.###
#.....#
#.....#
###^###