###########################
#..#.....#T#^#..........#T#
#..#..#..#.#.#..######....#
#.....#....#/#..M.........#
#..#..######.####..#####..#
##.#....#.......#..#.G.#..#
#..###..#..###..,..##.##..#
#..#....#..#A#..#.........#
#G.#....#.......###########
#####,,#######.##.....#.!.#
#.......#...#...#.M.###...#
#.........................#
#.p.....#...#...#.....#...#
###########################