####^###################
#p#...#................#
#.#...#..###########...#
#.##.##..#...#######...#
#...M......G.#.........#
#........#...#.....#...#
#........#####..#####..#
#........#A.....##..#..#
#........#......##../..#
#####,,###########..#..#
####........T.......#..#
####................#..#
########################